* * * * * * * * *
* _ _ _ _ _ _ _ *
* _ _ _ _ _ _ _ *
* _ _ _ A  _ _ *
* _ _ _ T _ _ _ *
* I I D I I I I *
* _ _ _ A _ _ _ *
* _ _ _ _ _ _ _ *
* * * * * * * * *