* * * * * * * * * * *
* _ _ _ A _ _ _ _ _ *
* _ _ _ _ _ _ _ _ _ *
* _ _ _ _ _ _ _ _ _ *
* _ _ _ _ _ _ _ _ _ *
* _ _ _ _ T _ _ _ _ *
* * * * * * * * * * *