* * D * * * * * * D *
* A _ _ _ I _ _ _ _ *
* _ _ _ _ I _ _ _ _ *
D _ _ _ _ I _ _ _ T D
* _ _ _ _ I _ _ _ _ *
* _ T _ _ D _ _ _ A *
* * * * * * * * * D *