* * * * * * * * * * *
* _ _ _ _ _ _ _ _ _ *
* _ _ _ A T _ _ _ _ *
* _ _ _ _ _ _ _ _ _ *
* * * * * * * * * * *