* * * * * * * * * * *
* _ A _ _ _ _ _ _ T *
* T _ _ _ _ _ _ _ _ *
* _ _ _ _ _ _ _ _ A *
* * * * * * * * * * *