* * * * * * * *
* T _ _ _ _ _ *
* _ _ _ _ _ A *
* _ _ _ _ _ _ *
* * * _ _ _ * *
* A _ * _ * _ *
* _ T * _ * A *
* * * * * * * *